1111111111111
1P0100M00C0E1
1001011111011
1C0000M0000C1
1111111111111