111111111111111111111111111111111
1P00000010000000000000001000000E1
101111101011111111101110101111101
10000C1000000M0000001C00000M00001
101110111110111110111011111110111
1000000000100C0010000000000010001
111011111010101010111110111010101
1C00M00000001C100000M0000010000C1
111111111111111111111111111111111