11111111111111111111111111111
1P0000001000000000010000000C1
10110110101111111010110111101
101C00100000000000001001C0001
10111011101110111111101101111
10000000001C000M0000000000001
11101111111011111011111110111
100000010000000000001000000E1
10110101011111111110101011011
1C000100000M000000000010000C1
11111111111111111111111111111